0000000000
0661111223
0661111233
1111122333
1111223334
5551223344
5511122223
5551111222
1155111222
1111122222
1111122266